0000000000000000000000000000078889000000000000000000
0000000000000000000000000000000000000000000000000000
0000000000000000000000000000000000000000000000000516
0000000000000000000000000000000000000000000000000324
0000000000000000000000000000000000000000000000000324
0000000000000000000000000000000000000000000000000324
516000000000000078890000000000000516000000000511ca24
3240000000000000000000000000000003240000000003222224
32bf0000000000000000000000005111ca2bf000000003222224
322bd6000000000000000000000032222222bd111111ca222224
322224000000000000000000000ea22222222222222222222224
32222bd1111111111111111111ca222222222222222222222224
3222222222222222222222222222222222222222222222222224
3222222222222222222222222222222222222222222222222224
3222222222222222222222222222222222222222222222222224
3222222222222222222222222222222222222222222222222224
3222222222222222222222222222222222222222222222222224