0000000000000000000000000000000000000000000000000000
0000000000000000000000000000000000000000000000000000
0000000000000000000000000000078889000000000000000000
0000000000000000000000000000000000000000000000000000
0000000000000000000000000000000000000000000000000516
0000000000000000000000000000000000000000000000000324
0000000000000000000000000000000000000000000000000324
0000000000000000000000000000000000000000000000000324
516000000000000078890000000000000516000000000511ca24
3240000000000000000000000000000003240000000003222224
32400000000000000000000000005111ca240000000003222224
32bd6000000000000000000000003222222bd1111111ca222224
3222400000000000000000000000322222222222222222222224
3222bd111111111111111111111ca22222222222222222222224
3222222222222222222222222222222222222222222222222224
3222222222222222222222222222222222222222222222222224
3222222222222222222222222222222222222222222222222224
3222222222222222222222222222222222222222222222222224
3222222222222222222222222222222222222222222222222224