0000000000000000000000000000000000000000000000000000
0000000000000000000000000000000000000000000000000000
0000000000000000000000000000000000000000000000000000
0000000000000000000000000000000000000000000000000000
0000000000000000000000000000000000000000000000000000
0000000000000000000000000000000000000000000000000000
0000000000000000000000000000000000000000000000000000
0000000000000000000000000000000000000000000000000000
0000000000000000000000000000000000000000000000000000
0000000000000000000000000000000000000000000000000000
0000000000000000000000000000000000000000000000000000
0000000000000000000000000000000000000000000000000000
0000000000000000000000000000000000000000000000000000
1111111111111111111111111111111111111111111111111111
2222222222222222222222222222222222222222222222222222
3333333333333333333333333333333333333333333333333333
4444444444444444444444444444444444444444444444444444
5555555555555555555555555555555555555555555555555555
5555555555555555555555555555555555555555555555555555