0000000000000000000000000788900000000000000000000000000000000000000000000000000000
0000000000000000000000000000000000000000000000000000000000000000000000000000000000
0000000000000000000000000000000000000000000000000000000007888888890000000000000056
0000000000000000000000000000000000000000005111160000000000000000000000000000000ea4
00000000000000000000000000000000000511111ca2222bd11116000000000000000511111111ca24
0000000000000000000000000000000000032222222222222222240000000000000003222222222224
0000000000000000000000000000000000032222222222222222240000000000000003222222222224
0000000000000000000005111111111111ca22222222222222222bf0000000000000ea222222222224
000000000000000000000322222222222222222222222222222222bd11111111111ca2222222222224
0078889000000000000003222222222222222222222222222222222222222222222222222222222224
0000000000000000000003222222222222222222222222222222222222222222222222222222222224
00000000000000000000ea222222222222222222222222222222222222222222222222222222222224
0000000000000000005ca2222222222222222222222222222222222222222222222222222222222224
0000000000000000003222222222222222222222222222222222222222222222222222222222222224
00000000000000000ea222222222222222222222222222222222222222222222222222222222222224
0000511111111111ca2222222222222222222222222222222222222222222222222222222222222224
0000322222222222222222222222222222222222222222222222222222222222222222222222222224
0000322222222222222222222222222222222222222222222222222222222222222222222222222224
0000giiiiiiiiiiiiiiiiiiiiiiiiiiiiiiiiiiiiiiiiiiiiiiiiiiiiiiiiiiiiiiiiiiiiiiiiiiiih