000000000000000000000000078890000000000000000000000000000000000000000000000000
000000000000000000000000000000000000000000000000000000000000000000000000000000
000000000000000000000000000000000000000000000000000000078888889000000000000056
000000000000000000000000000000000000000005111600000000000000000000000000000ea4
0000000000000000000000000000000000511111ca222bd111160000000000000051111111ca24
000000000000000000000000000000000032222222222222222400000000000000322222222224
000000000000000000000000000000000032222222222222222400000000000000322222222224
000000000000000000000511111111111ca2222222222222222bf000000000000ea22222222224
0000000000000000000003222222222222222222222222222222bd1111111111ca222222222224
007888900000000000000322222222222222222222222222222222222222222222222222222224
000000000000000000000322222222222222222222222222222222222222222222222222222224
00000000000000000000ea22222222222222222222222222222222222222222222222222222224
0000000000000000005ca222222222222222222222222222222222222222222222222222222224
000000000000000000322222222222222222222222222222222222222222222222222222222224
00000000000000000ea22222222222222222222222222222222222222222222222222222222224
0000511111111111ca222222222222222222222222222222222222222222222222222222222224
000032222222222222222222222222222222222222222222222222222222222222222222222224
000032222222222222222222222222222222222222222222222222222222222222222222222224
0000giiiiiiiiiiiiiiiiiiiiiiiiiiiiiiiiiiiiiiiiiiiiiiiiiiiiiiiiiiiiiiiiiiiiiiiih