0000000000000000000000000000000000000000000000000000
0000000000000000000000000000000000000000000000000000
0000000000000000000000000000000000000000000000000000
0000000000000000000000000000000000000000000000000000
0000000000000000000000000000000000000000000000000000
0000000000000000000000000000000000000000000000000000
0000000000000000000000000000000000000000000000000000
0000000000000000000000000000000000000000000000000000
0000000000000000000000000000000000000000000000000000
0000000000000000000000000000000000000000000000000000
0000000000000000000000000000000000000000000000000000
0000000000000000000000000000000000000000000000000000
0000000000000000000000000000000000000000000000000000
5111111111111111111111111111111111111111111111111116
3222222222222222222222222222222222222222222222222224
3222222222222222222222222222222222222222222222222224
3222222222222222222222222222222222222222222222222224
3222222222222222222222222222222222222222222222222224
3222222222222222222222222222222222222222222222222224